11111111111111111111111111111
1P10000000010000000010CCC01E1
101CC000X0010000X000101110101
10111000000100CCCCCC10101CCC1
10000000000100111111101011111
1CCCCCCC0CCC000000X1000000X01
11111111011100000001000000001
10000C0000010000000100X000001
10X001000001X000000C000000001
1CCCC1CC0CC1CCCCCCC1CCCCCCC01
11111111011111111011111111101
10CCCCCCCCCCCCCCCCCCC10CCCCC1
10111111111111111111110111111
1CCCCCCCCC1CCCCCCCCCCCCCCCCC1
11111111111111111111111111111