11111111111111111111111111111
100000000000000000000000X0001
10000000000000000000000000001
10000000000000000000000000001
10000000000000X00000000000001
10000000000000000000000000001
1P000000000000000C000000000E1
10000000000000000000000000001
10000000000000000000000000001
10000000000000000000000000001
100000000000000X0000000000001
10000000000000000000000000001
10000000000000000000000000001
10000000000000000000000000001
11111111111111111111111111111