1111111111111
1000C00010101
1CC01C0C1C0C1
1110111111011
1000000010001
1C1C000C1C001
1111101111101
100C000100001
1C01C00100C01
111110010C1C1
1P11100101111
1000C000000E1
1111111111111