1111111111111
1000000000001
1000000000001
1000000000001
1000000000001
1000000000001
100P00C0000E1
1000000000001
1000000000001
1000000000001
1000000000001
1000000000001
1111111111111