111111111111111111111111111111
1000000C0000000100000010000001
100000111100000100000010000001
100000010000000100S0001000CCC1
1CCC00010000000100000010001111
111100010000000100000010000001
1P01000100000CC100000010000E01
100100010000011100CCCC10000001
10010001000000010011111000S001
100100010000000100000000000001
10010001000000010000CCCCCCCCC1
10010001000CCCC100001111111111
100100010001111100000000000001
10000C010000000000C000000C0001
111111111111111111111111111111