111111111111111111111111111111
100000000000000000000000000001
100000000000000000000000000001
10000000000000000000C000000001
1000000S0000000000011100000001
100000000000000000000000000001
1P0000000000000000000000000E01
100000000000000000000000000001
100000000000000000000000000001
100000000000000C00000000000001
100000000000001110000000000001
100000000000000000000000S00001
100000000000000000000000000001
100000000000000000000000000001
111111111111111111111111111111