111111111111111111111111111111
1P100000000100000000100C0010E1
101C00000S010000S0001011101011
10111000000100C0000C10101C00C1
100000000001001111111010111111
1C00C00C0000000000010000000001
11111111011100000S01000000S001
100000000001000S000100S0000001
10S000000001000000000000000001
1C00C0CC0CC1C00000C1C0C0C0C0C1
111011110111111110111111111011
10C0C01C00C10C00000CC10000C0C1
10101011111111101111110S001111
1C000C000C1C0000C001C0000000C1
111111111111111111111111111111